20 20 80
####################
#  *           * @ #
#H#####H      H#####
#H     H      H    #
#H     H------H    #
#H+    H      H    #
#H#####H      H----#
#H     H    + H   ##
#H     H######H    #
#H#####H      H    #
#H  D  H------H    #
########       ###H#
#  H              H#
#  H-------       H#
###H       ####H####
#  H           H   #
#  H-----------H   #
#  H               #
#  H     %       + #
####################

50 50 60
##################################################
#  #     #    ###   #     #                      #
#  #  #  #   #   #  #  #  #                      #
#  # # # #   #   #  # # # #                      #
#  ##   ##    ###   ##   ##                      #
#                                                #
#         #   #   ###   #  #  ###    #####       #
#          # #   #   #  #  #  #  #   #           #
#           #    #   #  #  #  ###    ###         #
#           #    #   #  #  #  #  #   #           #
#           #     ###    ##   #   #  #####       #
#                                                #
#               ######    ###    ###   ###    ## #
#               #        #   #  #   #  #  #   ## #
#               #  ##    #   #  #   #  #   #  ## #
#               #    #   #   #  #   #  #  #      #
#               ######    ###    ###   ###    ## #
#                                                #
################H#############################H###
#               H#                            H  #
#               H#------------------------    H  #
#               H#                     ###########
#        %      H#                               #
####H#############                               #
#   H                                            #
#   H                                            #
#   H       ---------------        %            D#
####H########             #############H##########
#                                      H         #
#                                      H         #
#                                      H         #
#                                      H         #
#                                      H         #
#                                      H         #
#H################################################
#H                                               #
#H                                               #
#H                        -----------------#######
######################H#####                    ##
#                     H                         ##
#                     H                  #########
#                     H                          #
#                     H            *             #
#                     ###H###############H########
#                        H                       #
# @    *      ---------  H        ----------     #
############H##       #############        #H#####
#           H                               H    #
#           H                               H    #
#        %  S                  %            H    #